20 21
100 100
8 2 2 2 2 2 2 2 2 2 2 2 2 2 2 2 2 2 2 7
9 0 0 0 0 0 0 0 0 0 0 0 0 0 0 0 0 0 0 9
9 0 0 0 0 0 0 0 0 0 0 0 0 0 0 0 0 0 0 9
9 0 0 8 2 2 7 0 0 0 0 0 0 8 2 2 7 0 0 9
9 0 0 9 0 0 9 0 0 0 0 0 0 9 0 0 9 0 0 9
9 0 0 9 0 0 9 0 0 0 0 0 0 9 0 0 9 0 0 9
9 0 0 11 0 0 11 0 0 0 0 0 0 11 0 0 11 0 0 9
9 0 0 0 0 0 0 0 0 0 0 0 0 0 0 0 0 0 0 9
9 0 0 10 0 4 2 2 2 3 0 4 2 2 3 0 10 0 0 9
9 0 0 9 0 0 0 0 0 0 0 0 0 0 0 0 9 0 0 9
9 0 0 0 0 0 0 0 0 0 0 0 0 0 0 0 0 0 0 9
9 0 0 9 0 0 0 0 0 0 0 0 0 0 0 0 9 0 0 9
9 0 0 11 0 4 2 2 2 3 0 4 2 2 3 0 11 0 0 9
9 0 0 0 0 0 0 0 0 0 0 0 0 0 0 0 0 0 0 9
9 0 0 10 0 0 10 0 0 0 0 0 0 10 0 0 10 0 0 9
9 0 0 9 0 0 9 0 0 0 0 0 0 9 0 0 9 0 0 9
9 0 0 9 0 0 9 0 0 0 0 0 0 9 0 0 9 0 0 9
9 0 0 6 2 2 5 0 0 0 0 0 0 6 2 2 5 0 0 9
9 0 0 0 0 0 0 0 0 0 0 0 0 0 0 0 0 0 0 9
9 0 0 0 0 0 0 0 0 0 0 0 0 0 0 0 0 0 0 9
6 2 2 2 2 2 2 2 2 2 2 2 2 2 2 2 2 2 2 5
